15 10
7 9
5
3
40 40 40 41 41 41 41 41 41 41 41 41 40 40 40
40 40 40 41 40 40 40 40 40 40 40 41 40 40 40
40 40 40 41 40 40 40 40 40 40 40 41 40 40 40
40 40 40 41 40 40 40 40 40 40 40 41 40 40 40
40 40 40 41 41 41 41 41 41 41 41 41 40 40 40
40 40 40 40 40 40 41 41 41 40 40 40 40 40 40
40 40 40 40 40 40 40 41 40 40 40 40 40 40 40
40 40 40 40 40 40 40 41 40 40 40 40 40 40 40
40 40 40 40 40 40 40 41 40 40 40 40 40 40 40
40 40 40 40 40 40 40 41 40 40 40 40 40 40 40

0  0  0  0  0  0  0  0  0  0  0  0  0  0  0
0  0  0  0  0  0  0  0  0  0  0  0  0  0  0
0  0  0  0  0  0  0  0  0  0  0  0  0  0  0
0  0  0  0  0  0  0  0  0  0  0  0  0  0  0
0  0  0  0  0  0  0  0  0  0  0  0  0  0  0
0  0  0  0  0  0  0  0  0  0  0  0  0  0  0
0  0  0  0  0  0  0  0  0  0  0  0  0  0  0
0  0  0  0  0  0  0  0  0  0  0  0  0  0  0
0  0  0  0  0  0  0  0  0  0  0  0  0  0  0
0  0  0  0  0  0  0  0  0  0  0  0  0  0  0
Congratulations! You won! #269#72