15 10
7 9
5
3
17 17 17 17 17 17 17 17 17 17 17 17 17 17 17
17 17 17 17  7  7  7  7  7  7  7 17 17 17 17
17 17 17 17  7 17 17 17 17 17  7 17 17 17 17
17 17 17 17  7 17  7  7  7 17  7 17 20 17 17
17 17 17 17  7 17  7 17  7 17  7 17 17 17 20
17 20 17 17  7 17  7 17  7 17  7 17 17 17 17
17 17 17 17  7 17  7  7  7 17  7 17 17 17 17
17 17 20 17  7 17 17 17 17 17  7 17 17 20 17
17 17 17 17  7  7  7  7  7  7  7 17 17 17 17
17 17 17 17 17 17 17 17 17 17 17 17 17 17 17

0  19  0  18  0  0  0  0  0  0  0  18  0  19  0
0  0  0  0  0  0  0  0  0  0  0  0  0  0  0
18  18  18  18  0  18  18  18  18  18  0  18  18  18  18
0  0  0  0  0  18  0  0  0  18  0 0  0  0  0
0  0  0  0  0  18  0  22  0  18  0  0  0  0  0
0  0  0  0  0  18  0 0  0  18  0  0  0  0  0
0  0  0  0  0  18  0 0 0  18  0  0  0  0  0
18  18  18  18  0  18  18  18  18  18  0  18  18  18  18
0  0  0  0  0  0  0  0  0  0  0  0  0  0  0
0  19  0  18 0  0  0  0  0  0  0  18  0  19  0
#0#0
