15 10
13 5
5
3
7 7 7 7 7 7 7 17 17 17 17 17 17 17 17
7 7 7 7 7 7 7 17 17 17 20 17 17 20 17
7 7 7 7 7 7 7 17 17 17 17 17 33 17 17
7 7 7 7 7 7 7 17 17 17 17 17 20 17 17
7 7 7 7 7 7 7 17 20 17 20 17 17 17 17
7 7 7 7 7 7 7 17 17 17 34 17 17 17 17
7 7 7 7 7 7 7 17 17 17 17 17 17 17 17
7 7 7 7 7 7 7 17 17 20 17 17 20 17 17
7 7 7 7 7 7 7 17 17 17 17 17 17 17 17
7 7 7 7 7 7 7 17 17 20 17 17 17 17 17

0  0  0  0  0  0  0  0  0  0  0  0  0  0  0
0  0  0  18  0  0  0  0  6  7  0  5  5  5  5
18 0  0  0  0  0  0  0  0  0  0  5  0  19 0
0  0  18  0  0  0  0  0  0  0  0  5  0  19 0
0  0  0  0  0  0  0  0  0  0  0  5  5  5  5
0  18 2  18 0  0  0  0  0  0  0  0  0  0  0
0  0  0  0  0  0  0  0  0  0  0  0  0  0  0
0  0  0  18 0  0  0  0  0  0  0  0  0  0  0
0  18 0  0  0  0  0  0  0  0  0  6  7  0  0
0  0  0  0  0  0  0  0  0  0  0  0  0  0  0
#0#0
