15 10
1 5
5
3
17 17 17 17 17 17 17 17 17 17 17 17 17 17 17
17 17 17 17 17 17 17 17 17 17 17 20 17 17 17
17 17 17 17 17 17 17 17 17 17 17 17 17 17 17
17 17 17 17 20 17 17 17 17 17 17 17 17 17 17
17 17 17 17 17 17 17 17 20 17 17 17 20 17 17
17 17 17 17  7  7  7  7  7  7  7 17 17 17 17
17 17 17 17 17 17 17 17 17 17 17 17 17 20 17
17 17 17 17 17 17 17 17 20 17 17 17 17 17 17
17 17 17 17 20 17 17 17 17 17 17 17 17 17 17
17 17 17 17 17 17 17 17 17 17 17 17 17 17 17

18 18 18 18 18 18 18 18 18 18 18 18 18 18 18
0  0  18 0  0  0  0  0  0  0  0  0  0  0  0
0  0  0  0  0  18 0  0  0  0  0  5  5  5  5
0  0  0  0  0  0  0  0  0  0  0  5  0  0  0
0  0  0  0  0  0  0  0  0  0  0  5  0  0  0
0  0  0  0  0  0  0  0  0  0  0  0  0  0  2
0  0  0  0  0  0  0  0  0  0  0  5  0  0  0
0  0  18 0  0  0  18 0  0  0  0  5  5  5  5
0  0  0  0  0  0  0  0  0  0  0  0  0  0  0
18 18 18 18 18 18 18 18 18 18 18 18 18 18 18
Mud is slippery... I lose control touching it#0#0
