15 10
1 5
5
3
17  17  17  17  17  17  17  17  17  17  17  17  17  17  17
17  7   17  7   7   7   7   7   7   7   17  7   17  7   17
17  7   17  7   17  17  17  17  17  7   17  17  17  7   17
17  7   17  7   17  7   7   7   7   7   7   7   7   7   17
17  17  17  7   17  7   17  17  17  7   17  17  17  17  17
17  7   7   7   17  7   7   7   17  7   7   7   17  7   17
17  17  17  7   17  17  17  7   17  7   17  17  17  17  17
17  7   17  7   7   7   7   7   17  7   17  7   17  7   17
17  17  17  17  17  17  17  17  17  17  17  17  17  17  17
17  7   17  7   17  7   17  7   17  7   17  7   17  7   17

18  18  18  18  18  18  18  18  18  18  18  18  18  18  18
18  0   18  0   0   0   0   0   0   0   18  0   18  19  18
18  2  18  0   18  18  18  18  18  0   18  18  18  0   18
18  0   18  0   18  0   0   0   0   0   0   0   0   0   18
18  18  18  0   18  0   18  18  18  0   18  18  18  18  18
18  0   0   0   18  0   0   0   18  0   0   0   18  0   18
18  18  18  0   18  18  18  0   18  0   18  18  18  18  18
18  0   18  0   0   0   0   0   18  0   18  0   18  0   18
18  18  18  18  18  18  18  18  18  18  18  18  18  18  18
18  0   18  0   18  0   18  0   18  0   18  0   18  0   18
#0#0
