15 10
1 5
7
3
17 17 17 17 17 17 17 17 7 17 17 33 17 7 7
17 17 17 17 17 20 17 20 7 7  7  7  7  7  7
17 17 17 20 17 17 17 17 7 17 17 17 17 17 17
17 17 17 17 17 17 17 17 7  7  17  17  17  17  7
17 17 34 17 17 20 17 17 7 17 33 17 17 17 17
17 17 17 17 17 17 17 17 7  7  17  17  17  17  7
17 17 17 20 17 17 17 17 7 17 17 17 17 17 17
17 17 17 17 17 20 17 20 7  7  7  7  7  7  7
17 17 17 17 17 17 17 17 7 7 7 7 7 7 7
17 17 17 17 17 17 17 17 7  17  17  33  17  7  7

18  18  0  0  6  7  0  0  0  18  0  0  0  0  0
18  5  0  0  0  0  0  0  0  0  0  0  0  0  0
18  0  0  0  0  0  0  0  0  18  0  0  0  0  0
18  0  0  0  0  0  0  0  0  0  13 13 13 13  0
18  0  0  0  0  0  0  0  0  18  0 0  2  0   18
18  0  0  0  0  0  0  0  0  0  13  13  13  13  0
18  0  0  0  0  0  0  0  0  18  0  0  0  0  0
18  5  0  0  0  0  0  0  0  0  0  0  0  0  0
18  0  6  7  0  0  0  0  0  0  0  0  0  0  0
18  18  0  0  0  0  0  0  0  18  0  0  0  0  0
#0#0
