10 10
5 5
1 3 3 1 1 3 1 1 3 3
3 1 1 3 1 3 1 1 1 3
3 1 1 3 3 3 1 3 3 1
1 1 1 3 3 3 1 3 1 3
1 3 1 1 1 3 3 3 3 1
3 1 3 3 3 1 1 3 1 3
3 3 3 3 1 1 1 1 3 1
1 1 1 3 1 3 3 3 1 3
1 3 3 1 1 3 3 1 1 3
3 3 1 1 3 1 1 1 1 3

0 0 0 0 0 0 0 0 0 0
0 0 0 0 0 0 0 0 0 0
0 0 0 0 0 0 0 0 0 0
0 0 0 0 0 0 0 0 0 0
0 0 0 0 0 0 0 0 0 0
0 0 0 0 0 0 0 0 0 0
0 0 0 0 0 0 0 0 0 0
0 0 0 0 0 0 0 0 0 0
0 0 0 0 0 0 0 0 0 0
0 0 0 0 0 0 0 0 0 0


