22 15
11 11
5
0
2 2 2 2 2 2 2 2 2 2 2 2 2 2 2 2 5 2 2 2 1 1 2
2 1 1 1 1 1 1 1 1 1 1 1 1 1 1 1 5 1 1 2 1 1 2
2 1 1 1 1 1 1 6 6 6 6 6 6 6 6 1 5 1 4 2 1 1 2
2 1 1 1 1 1 1 1 1 1 1 1 1 1 1 1 5 1 1 2 1 1 2
2 1 1 1 4 1 1 1 1 1 1 1 1 1 1 1 5 1 1 2 1 1 2
2 1 1 1 1 1 1 1 1 1 1 1 1 1 1 1 5 1 1 2 1 1 2
2 1 1 1 1 1 1 1 1 1 1 1 1 1 1 1 5 1 1 2 1 1 2
2 1 1 1 1 1 1 1 1 1 1 1 1 1 1 1 5 1 1 2 1 1 2
2 1 1 1 1 1 1 1 1 1 1 1 1 3 1 1 5 1 1 2 1 1 2
2 1 1 1 1 1 1 1 1 1 1 1 1 1 1 1 5 1 1 2 1 1 2
2 1 1 1 1 1 1 1 1 1 1 1 1 1 1 1 5 1 1 2 1 1 2
2 1 1 1 1 1 1 1 1 1 1 1 1 1 1 1 5 1 1 2 1 1 2
2 1 1 1 6 1 6 6 6 6 6 6 1 1 1 1 5 1 1 2 1 1 2
2 1 1 1 1 1 6 6 6 6 6 6 1 1 1 1 5 1 1 2 1 1 2
2 2 2 2 2 2 2 2 2 2 2 2 2 2 2 2 5 2 2 2 1 1 2

0 0 0 0 0 0 0 0 0 0 0 0 0 0 0 0 0 0 0 0 0 0 0
0 0 0 0 0 0 0 0 0 0 0 0 0 0 0 0 0 0 0 0 0 0 0
0 0 0 0 0 0 0 0 0 0 0 0 0 0 0 1 0 0 0 0 0 0 0
0 0 0 0 0 0 0 0 0 0 0 0 0 0 0 0 0 0 0 0 0 0 0
0 0 0 0 0 0 0 0 0 0 0 0 0 0 0 0 0 0 0 0 0 0 0
0 0 0 0 0 0 0 0 0 0 0 0 0 0 1 0 0 0 0 0 0 0 0
0 0 0 0 0 0 0 0 0 0 0 0 0 0 1 0 0 0 0 0 0 0 0
0 0 0 0 0 0 0 1 0 1 0 0 0 0 0 0 0 0 1 0 0 0 0
0 0 0 0 0 0 0 0 0 0 0 0 0 0 0 0 0 0 1 0 0 0 0
0 0 0 0 0 1 0 0 0 0 0 0 0 0 0 0 0 0 0 0 0 0 0
0 0 1 0 1 0 1 0 1 0 1 0 1 0 0 0 0 0 0 0 0 0 0
0 0 0 0 0 0 0 0 0 0 0 0 0 0 0 0 0 0 0 0 0 2 0
0 0 0 0 0 0 0 0 0 0 0 0 0 0 0 0 0 0 0 0 0 0 0
0 0 0 0 0 0 0 0 0 0 0 0 0 0 0 0 0 0 0 0 0 0 0
0 0 0 0 0 0 0 0 0 0 0 0 0 0 0 0 0 0 0 0 0 0 0

