15 10
7 5
0
1
8 8 8 8 8 8 8 8 9 8 8 8 8 8 8
8 8 8 8 8 8 19 8 19 8 8 9 8 8 8
8 8 8 9 8 8 19 8 19 8 8 8 8 8 8
8 8 8 8 8 8 8 8 8 8 8 8 9 8 8
8 8 8 9 8 8 9 8 8 8 8 8 8 8 8
8 8 8 8 8 8 8 8 8 9 8 8 8 8 8
8 8 8 8 9 8 8 8 8 8 8 8 8 8 8
8 8 8 8 8 8 8 9 8 8 8 8 8 8 8
8 9 8 8 8 8 8 8 8 8 8 8 8 8 8
8 8 8 8 8 8 8 8 8 8 9 8 8 8 8

4 4 4 4 4 4 4 4 4 4 4 4 4 4 4
4 0 0 0 0 0 24 10 24 0 0 0 0 0 4
4 0 0 0 0 0 24 11 24 0 0 0 0 0 4
4 0 0 0 0 0 0 0 0 0 0 0 0 0 4
4 0 0 12 0 0 0 0 0 0 0 26 0 0 4
4 0 0 0 0 0 0 0 0 0 0 0 0 0 4
4 0 0 0 0 0 0 0 0 0 0 0 0 0 4
4 0 0 16 0 0 0 0 0 0 0 27 0 0 4
4 0 0 0 0 0 0 0 0 0 0 0 0 0 4
4 4 4 4 4 4 4 4 4 4 4 4 4 4 4
I need to open that door...#0#0