15 10
1 5
0
1
8 8 8 8 8 8 8 8 9 8 8 8 8 8 8
8 8 8 8 8 8 8 8 8 8 8 9 8 8 8
8 8 8 9 8 8 8 8 8 8 8 8 8 8 8
8 8 8 8 8 8 8 8 8 8 8 8 9 8 8
8 8 8 9 8 8 9 8 8 8 8 8 8 8 8
8 8 8 8 8 8 8 8 8 9 8 8 8 8 8
8 8 8 8 9 8 8 8 8 8 8 8 8 8 8
8 8 8 8 8 8 8 9 8 8 8 8 8 8 8
8 9 8 8 8 8 8 8 8 8 8 8 8 8 8
8 8 8 8 8 8 8 8 8 8 9 8 8 8 8

4 4 4 4 4 4 4 4 4 4 4 4 4 4 4
4 4 4 4 4 4 4 4 4 4 4 4 4 4 4
0 0 0 0 5 0 0 0 0 0 0 0 0 0 0
0 0 0 0 5 0 0 0 0 6 7 0 0 0 0
0 0 0 0 5 6 7 6 7 0 0 8 0 0 2
0 0 0 0 0 0 0 0 0 0 0 9 0 0 0
0 0 0 0 5 6 7 6 7 8 0 0 0 0 0
0 0 0 0 5 0 0 0 0 9 0 0 0 0 0
4 4 4 4 4 4 4 4 4 4 4 4 4 4 4
4 4 4 4 4 4 4 4 4 4 4 4 4 4 4
I can always press R to restart the level.#0#0