15 10
5 9
0
1
8 8 8 8 8 8 8 8 8 8 8 8 8 8 8
8 8 8 8 8 8 8 8 8 8 8 8 8 8 8
8 8 8 9 8 8 8 8 8 8 8 8 8 8 8
8 8 9 8 8 8 8 8 8 8 8 8 8 8 8
8 8 8 8 14 8 8 9 8 8 8 8 8 8 8
8 8 8 8 8 8 8 8 8 8 8 8 8 8 8
8 8 8 8 8 8 8 8 8 8 8 8 8 8 8
8 8 9 8 14 9 8 8 8 8 8 8 8 8 8
8 8 8 8 8 8 8 8 8 8 8 8 8 8 8
8 8 8 8 8 8 8 8 8 8 8 8 8 8 8

4 4 4 4 4 4 4 4 4 4 4 4 4 4 4
4 4 0 0 0 0 0 0 4 4 4 4 4 4 4
4 4 0 0 2 0 0 0 4 4 4 4 4 4 4
4 4 0 0 0 0 0 0 4 4 4 4 4 4 4
4 4 0 0 0 0 0 0 4 4 4 4 4 4 4
4 4 6 7 5 6 7 5 4 4 4 4 4 4 4
4 4 0 0 0 0 0 0 4 4 4 4 4 4 4
4 4 0 0 0 0 0 0 4 4 4 4 4 4 4
4 4 0 0 0 0 0 0 4 4 4 4 4 4 4
4 4 0 0 0 0 0 0 4 4 4 4 4 4 4
I can enter holes by pressing E #0#0
Select another hole with A and D...#0#36
I dig to the other hole with Q and exit with E#0#72
