15 10
13 7
3
1
8 8 8 8 8 8 8 8 9 8 8 8 8 8 8
8 8 8 8 8 8 8 8 8 8 8 9 8 8 8
8 8 8 9 8 8 8 8 8 8 8 8 14 8 8
8 8 8 8 8 8 8 8 8 8 8 8 9 8 8
8 8 8 9 8 8 9 8 8 8 8 8 8 8 8
8 8 8 8 8 8 8 8 8 9 8 8 8 8 8
8 8 8 8 9 8 14 8 8 8 8 8 8 8 8
8 8 8 8 8 8 8 9 8 8 8 8 8 8 8
8 9 8 8 8 8 8 8 8 8 8 8 8 8 8
8 8 8 8 8 8 8 8 8 8 9 8 8 8 8

4 4 4 4 4 4 4 4 4 4 4 4 4 4 4
4 0 0 0 0 0 0 0 0 0 5 0 2 0 4
4 0 0 0 0 0 0 0 0 0 5 0 0 0 4
4 0 0 0 0 0 0 0 0 0 5 0 0 0 4
4 0 0 0 0 0 0 0 0 0 5 5 5 5 4
4 0 0 6 7 0 0 0 0 0 0 0 0 0 4
4 0 0 0 0 0 0 0 0 0 0 0 0 0 4
4 0 0 0 0 0 0 0 0 6 7 0 0 0 4
4 0 0 0 0 0 0 0 0 0 0 0 0 0 4
4 4 4 4 4 4 4 4 4 4 4 4 4 4 4
I can eat grass with E and make a dirt patch#0#0
I can dig from a hole to a dirt patch#0#32