15 10
2 8
0
1
8 8 8 8 8 8 8 8 8 8 8 8 8 8 8
8 8 8 8 8 8 8 8 8 8 8 14 8 8 8
8 8 8 8 8 8 8 8 8 8 8 8 8 8 8
8 8 8 8 8 8 8 8 8 8 8 8 8 8 8
8 8 8 14 8 8 8 8 8 14 8 8 8 8 8
8 8 8 8 8 14 8 8 14 8 8 8 8 8 8
8 8 8 8 8 8 8 8 8 8 8 8 8 8 8
8 8 8 8 8 8 8 8 8 8 8 8 8 8 8
8 8 8 14 8 8 8 8 8 8 14 8 8 8 8
8 8 8 8 8 8 8 8 8 8 8 8 8 8 8

4 4 4 4 4 4 4 4 4 4 4 4 4 4 4
4 0 0 0 0 0 0 4 0 0 0 0 0 0 4
4 0 0 0 0 0 0 4 0 0 0 0 0 0 4
4 0 0 0 0 0 0 4 0 0 0 2 0 0 4
4 0 0 0 0 0 0 4 0 0 0 0 0 0 4
4 0 0 0 0 0 0 4 0 0 0 0 0 0 4
4 5 0 0 0 0 0 4 0 0 0 5 0 0 4
4 0 5 0 0 0 0 4 0 0 0 0 0 0 4
4 0 0 0 0 5 0 4 0 0 0 0 0 0 4
4 4 4 4 4 4 4 4 4 4 4 4 4 4 4
I can only reach holes 4 tiles away from me#0#0