15 10
5 5
2
1
8 8 8 8 8 8 8 8 9 8 8 8 8 8 8
8 8 8 8 8 8 8 8 8 8 8 9 8 8 8
8 8 8 9 8 8 8 8 8 8 8 8 8 8 8
8 8 8 8 8 8 8 8 8 8 8 8 9 8 8
8 8 8 9 8 8 9 8 8 8 8 8 8 8 8
8 8 8 8 8 8 8 8 8 9 8 8 8 8 8
8 8 8 8 9 8 8 8 8 8 8 8 8 8 8
8 8 8 8 8 8 8 9 8 8 8 8 8 8 8
8 9 8 8 8 8 8 8 8 8 8 8 8 8 8
8 8 8 8 8 8 8 8 8 8 9 8 8 8 8

4 4 4 4 4 4 4 4 4 4 4 4 4 4 4
4 4 4 4 4 4 4 4 4 4 4 4 4 4 4
0 0 0 0 0 0 0 0 0 0 0 0 0 0 0
0 0 0 0 0 0 0 0 0 0 0 0 0 0 0
0 0 0 0 0 0 0 0 0 0 0 0 0 0 0
0 0 0 0 0 0 0 0 0 0 0 0 0 0 0
0 0 0 0 0 0 0 0 0 0 0 0 0 0 0
0 0 0 0 0 0 0 0 0 0 0 0 0 0 0
4 4 4 4 4 4 4 4 4 4 4 4 4 4 4
4 4 4 4 4 4 4 4 4 4 4 4 4 4 4
