15 10
2 1
5
0
1 1 1 1 1 1 1 1 6 1 1 1 1 1 1
1 4 1 1 1 1 1 1 1 1 1 6 1 1 1
1 1 1 6 1 1 1 6 1 6 1 1 1 6 1
1 6 1 1 1 1 1 1 6 1 1 6 6 1 1
1 1 1 6 1 1 6 1 1 1 1 1 1 1 1
1 6 1 1 1 1 1 1 1 6 1 1 1 6 1
1 1 1 1 6 1 1 1 1 1 1 6 1 1 1
1 1 1 1 1 1 1 6 1 1 1 1 1 4 1
1 6 1 1 6 1 6 1 1 1 1 1 1 1 1
1 1 1 1 1 1 1 1 1 1 6 1 1 1 1

15 15 15 15 15 15 15 15 15 15 15 15 15 15 15
15 0 0 0 15 15 15 15 15 15 15 15 15 15 15
15 0  0  0  15 0  0  0  0  0  15 0  0  0  15
15 0  15 0  15 0  15 15 15 0  15 0  15 15  15
15 0  15 0  0  0  15 0  0  0  15 0  15 0  15
15 0  15 15 15 0  15 0  15 15 15 0  15 0  15
15 0  0  0  15 0  15  0  15 0  0  0  15 0  15
15 15 15 0  15 15 15 0  15 0  15 15 15 0  15
15 15 15 0  0  0  0 0  0  0  0  0  15 2  15
15 15 15 15 15 15 15 15 15 15 15 15 15 15 15
#0#0
