15 10
3 4
5
0
1 1 1 1 1 1 1 1 6 1 1 1 1 1 1
1 1 1 1 1 1 1 1 1 1 1 6 1 1 1
1 1 1 6 1 1 4 1 1 1 1 1 1 1 1
1 1 1 1 1 1 1 1 1 1 1 2 2 2 1
1 1 1 4 1 1 6 1 1 4 1 2 2 2 1
1 1 1 1 1 1 1 1 1 6 1 2 2 2 1
1 1 1 1 6 1 1 1 1 1 1 1 1 1 1
1 1 1 1 1 1 4 6 1 1 1 1 1 1 1
1 6 1 1 1 1 1 1 1 1 1 1 1 1 1
1 1 1 1 1 1 1 1 1 1 6 1 1 1 1

15 15 15 15 15 15 15 15 15 15 15 15 15 15 15
0 0 0 0 0 0 0 0 0 0 0 0 0 0 0
0 0 15 0 15 0 0 0 0 0 0 13 13 13 14
0 15 0 0 0 15 0 0 0 0 0 0 0 0 14
15 0 0 0 0 0 15 0 0 0 0 0 2 0 14
15 0 0 0 0 0 15 0 0 0 0 0 0 0 14
0 15 0 0 0 15 0 0 0 0 0 13 13 13 14
0 0 15 0 15 0 0 0 0 0 0 0 0 0 0
0 0 0 0 0 0 0 0 0 0 0 0 0 0 0
15 15 15 15 15 15 15 15 15 15 15 15 15 15 15
If i eat too much grass i become full...#0#0
