15 10
2 8
3
0
1 1 1 1 1 1 1 1 6 1 1 1 1 1 1
1 1 1 1 1 4 1 1 1 1 6 1 6 1 6
4 1 1 1 1 6 1 1 1 1 6 6 6 6 6
1 1 1 1 1 1 1 1 1 1 1 1 1 1 1
1 4 1 1 1 1 1 4 1 6 1 1 1 4 1
1 1 1 1 1 1 1 1 1 1 1 1 1 1 1
1 4 6 1 1 1 6 4 1 1 1 1 1 4 1
1 1 1 1 1 1 1 1 1 1 1 1 6 1 1
1 4 6 1 1 1 1 4 1 1 1 1 1 4 1
1 1 1 1 1 1 1 1 1 1 6 1 1 1 1

15 15 15 15 15 15 15 15 15 15 15 15 15 15 15
0 0 0 14 0 0 0 0 0 14 0 15 20 15 0
0 0 0 14 0 0 0 0 0 14 0 0 0 0 0
13 13 13 13 13 13 13 13 13 13 13 13 0 13 13
0 0 0 14 0 0 0 0 0 0 0 14 0 0 0
13 13 13 13 13 13 13 13 13 13 13 13 13 13 13
0 0 0 14 0 0 0 0 0 0 0 14 0 0 0
13 13 13 13 13 13 13 13 13 13 13 13 13 13 13
0 0 0 14 0 0 0 0 0 0 0 14 0 0 0
15 15 15 15 15 15 15 15 15 15 15 15 15 15 15
#0#0
