15 10
13 7
5
0
1 1 1 1 1 1 1 1 6 1 1 1 1 1 1
1 1 1 1 1 1 1 1 1 1 1 6 1 1 1
1 4 1 6 4 1 1 1 1 1 1 1 1 1 1
1 1 1 1 1 1 1 1 4 1 1 1 6 1 1
6 6 6 1 1 1 6 1 1 1 1 4 1 1 1
6 6 6 1 1 1 1 1 1 6 1 1 1 1 4
6 6 6 1 6 1 1 1 1 1 1 1 1 1 1
6 6 6 1 1 1 1 6 1 1 1 1 1 1 1
6 6 6 1 1 1 4 1 1 1 4 1 1 4 1
1 1 1 1 1 1 1 1 1 1 6 1 1 1 1

15 15 15 15 15 15 15 15 15 15 15 15 15 15 15
0 2 0 15 0 0 0 14 0 0 15 0 0 0 0
0 0 0 15 0 0 0 14 0 0 15 0 0 0 0
15 15 15 15 0 0 0 14 0 0 15 0 0 0 0
0 0 0 15 15 15 15 14 0 0 15 0 0 0 0
0 0 0 15 0 0 0 14 0 0 15 0 0 0 0
0 0 0 15 0 0 0 14 0 0 15 0 15 15 15
0 0 0 15 0 0 0 14 15 15 15 15 15 0 0
0 0 0 15 0 0 0 14 0 0 0 0 15 0 0
15 15 15 15 15 15 15 15 15 15 15 15 15 15 15
#0#0
