15 10
7 7
2
0
1 1 1 1 1 1 1 1 6 1 1 1 1 1 1
1 4 1 1 1 1 1 1 1 1 1 6 1 4 1
1 1 1 6 1 1 1 1 1 1 1 1 1 1 1
1 1 1 1 1 1 1 1 1 1 1 1 6 1 1
1 1 1 6 1 1 1 3 1 1 1 1 1 1 1
1 1 1 1 1 1 1 1 1 6 1 1 1 1 1
1 1 1 1 6 1 1 1 1 1 1 1 1 1 1
1 1 1 1 1 1 1 6 1 1 1 1 1 1 1
1 4 1 1 1 1 1 1 1 1 1 1 1 4 1
1 1 1 1 1 1 1 1 1 1 6 1 1 1 1

15 15 15 15 15 15 15 15 15 15 15 15 15 15 15
0 0 0 0 0 0 0 0 0 0 0 0 0 0 0
0 0 0 0 15 0 0 5 0 0 15 0 0 0 0
0 0 0 0 15 0 5 2 5 0 15 0 0 0 0
13 13 13 13 15 0 5 0 5 0 15 13 13 13 13
0 0 0 0 15 0 0 5 0 0 15 0 0 0 0
0 0 0 0 15 0 0 0 0 0 15 0 0 0 0
0 0 0 0 15 0 0 0 0 0 15 0 0 0 0
0 0 0 0 0 0 0 0 0 0 0 0 0 0 0
15 15 15 15 15 15 15 15 15 15 15 15 15 15 15
Restart with R if needed#0#0
