15 10
12 7
5
2
10 10 10 10 10 10 10 10 10 10 10 10 10 10 10
10 10 10 10 10 10 10 10 10 10 10 10 10 10 10
10 10 31 26 26 26 26 26 26 26 30 10 10 10 10
10 10 28 25 25 27 27 27 25 25 29 10 10 10 10
10 10 28 25 32 15 10 10 35 25 29 10 10 10 10
10 10 28 29 10 10 10 10 23 28 29 24 10 10 10
10 10 28 25 30 15 10 10 31 25 29 10 10 10 10
10 10 28 25 25 26 26 26 25 25 29 10 10 10 10
10 10 35 27 27 27 27 27 27 27 32 10 10 10 10
10 10 10 10 10 10 10 10 10 10 10 10 10 10 10

17 17 17 0 0 0 17 0 0 0 17 0 0 0 0
17 17 1 0 17 0 0 0 17 0 0 0 0 0 0
17 17 0 0 0 0 0 0 0 0 0 0 0 0 0
17 17 0 0 0 0 0 0 0 0 0 0 0 0 0
17 17 0 0 0 0 0 0 0 0 0 13 13 0 0
17 17 0 0 0 2 0 0 0 0 0 0 14 0 0
17 17 0 0 0 0 0 0 0 0 0 13 13 0 0
17 17 0 0 0 0 0 0 0 0 0 0 0 0 0
17 17 0 0 0 0 0 0 0 0 0 0 0 0 0
17 17 17 0 0 0 17 0 0 0 17 0 0 0 0
#0#0
