15 10
8 3
3
2
10 10 28 29 10 10 10 10 10 10 10 10 10 10 10
10 23 28 29 10 10 10 10 10 10 10 10 10 10 10
26 26 25 29 10 10 10 10 10 10 10 10 10 24 10
27 27 27 32 10 10 15 10 10 10 10 10 10 10 10
10 10 10 10 10 10 10 10 10 10 10 10 10 10 10
10 10 10 10 10 10 10 10 10 10 10 10 10 10 10
26 26 26 30 10 10 10 10 15 10 10 10 10 10 10
10 10 28 29 10 10 10 10 10 10 10 10 10 10 10
10 23 28 29 10 15 10 10 10 10 10 10 10 10 10
10 10 28 29 10 10 10 10 10 10 10 10 10 10 10

1 0 0 0 0 17 17 17 17 17 17 17 17 17 17
0 0 0 0 0 0 0 0 0 0 0 0 0 0 0
0 0 0 0 0 0 0 0 0 0 0 0 0 0 0
0 0 0 0 0 0 0 0 0 0 0 0 0 0 0
0 0 0 0 0 0 0 0 0 17 17 17 17 17 17
0 0 0 0 0 0 0 0 0 17 0 0 0 0 0
0 0 0 0 0 0 0 0 0 17 0 17 17 17 17
0 0 0 0 0 0 0 0 0 17 0 17 0 0 0
1 0 0 0 0 0 0 0 0 17 0 17 0 2 0
1 1 0 0 0 0 0 0 0 17 0 17 0 0 0 0
#0#0
