15 10
2 2
5
2
25 27 27 25 25 25 25 25 25 25 25 25 25 25 25
29 10 10 28 27 27 25 27 27 25 27 27 25 25 25
29 10 10 28 10 10 25 10 10 25 10 10 25 25 25
25 26 26 25 26 26 25 26 26 25 26 26 25 25 25
25 25 25 25 25 25 25 25 25 25 25 10 25 25 25
25 25 25 25 25 25 25 25 25 25 25 10 25 27 27
25 25 25 25 25 25 25 25 25 25 25 25 29 10 10
25 25 25 25 25 25 25 25 25 27 25 10 29 10 10
25 25 25 25 25 25 25 25 29 24 28 10 29 23 10
25 25 25 25 25 25 25 25 25 26 25 25 25 26 26

0 0 0 0 0 0 0 0 0 0 0 0 0 0 0
0 1 0 0 0 0 0 0 0 0 0 0 0 0 0
0 0 0 0 0 1 0 0 1 0 0 1 0 0 0
0 0 0 0 0 0 0 0 0 0 0 0 0 0 0
0 0 0 0 0 0 0 0 0 0 0 0 0 0 0
0 0 0 0 0 0 0 0 0 0 0 1 0 0 0
0 0 0 0 0 0 0 0 0 0 0 0 0 0 0
0 0 0 0 0 0 0 0 0 0 0 0 0 0 2
0 0 0 0 0 0 0 0 0 0 0 1 0 0 0
0 0 0 0 0 0 0 0 0 0 0 0 0 0 0
#0#0
