15 10
12 6
5
2
10 10 10 16 10 10 10 10 10 10 10 10 10 10 10
10 10 10 16 10 10 10 10 10 10 10 15 10 10 10
10 10 10 16 10 10 10 10 10 10 10 10 10 10 10
10 10 10 16 10 10 10 10 10 10 10 10 10 10 10
10 10 10 16 10 10 15 10 10 10 10 10 10 10 10
10 10 10 16 10 10 10 10 10 15 10 10 10 10 10
10 10 10 16 10 10 10 10 10 10 10 10 10 10 10
10 10 10 16 10 10 10 15 10 10 10 10 10 10 10
10 10 10 16 10 10 10 10 10 10 10 10 10 10 10
10 10 10 16 10 10 10 10 10 10 10 10 10 10 10

0 0 0 0 0 0 0 0 5 5 0 0 0 0 0
0 0 17 0 0 0 0 0 5 0 0 0 0 17 0
17 0 0 0 0 0 0 0 0 0 0 0 0 0 0
0 0 0 0 0 0 0 17 0 0 1 0 0 0 0
0 2 0 0 0 0 0 0 0 0 0 0 0 0 0
0 0 0 0 0 0 0 0 0 0 1 0 0 0 17
0 0 0 0 0 0 0 0 0 0 0 0 0 0 0
0 0 0 0 0 0 0 0 0 0 1 0 0 0 0
0 17 0 0 0 0 0 0 17 0 0 17 0 0 0
0 0 0 0 0 0 0 0 0 0 0 0 0 0 0
I can eat the fruit and press LSHIFT#0#0
to jump in the direction I'm facing#0#36
