15 10
11 6
5
2
10 10 10 10 10 10 10 10 10 28 25 25 25 25 25
10 23 10 10 10 10 10 10 10 35 27 27 27 25 25
10 10 10 10 10 10 10 10 10 10 10 10 10 28 25
10 10 10 10 10 10 10 10 10 10 10 10 10 28 25
10 10 10 10 10 10 10 10 10 10 10 10 10 35 27
10 10 10 10 10 10 10 10 10 10 10 10 10 10 10
10 10 23 10 10 10 10 10 10 10 10 10 10 10 10
10 10 10 10 24 10 10 10 10 10 10 10 10 10 10
10 10 10 10 10 10 10 10 10 10 10 10 10 10 10
10 10 10 10 10 10 10 10 10 10 10 10 10 10 10

5 21 5 17 17 17 17 17 0 0 0 0 0 0 0
0 0 0 17 17 17 17 17 0 0 0 0 0 0 0
17 17 17 17 17 17 17 17 0 0 1 1 1 0 0
0 17 0 17 0 17 0 17 0 0 1 1 1 0 0
0 17 0 17 17 17 17 17 0 0 0 0 0 0 0
0 0 17 0 17 0 0 17 0 0 0 0 0 0 0
17 17 0 17 17 17 17 17 0 0 0 0 0 0 0
0 0 17 17 0 17 0 17 0 0 0 0 0 0 0
17 17 17 0 0 17 0 17 0 0 0 0 0 0 0
1 0 17 0 17 17 0 17 0 0 0 0 0 0 0
#0#0
