15 10
1 7
5
3
36 36 36 36 36 36 36 36 36 36 36 36 36 36 36
36 39 36 36 36 36 36 36 36 36 36 36 36 36 36
36 36 36 36 36 36 39 36 36 36 36 36 36 36 36
36 36 36 36 39 36 36 36 36 36 36 36 36 36 36
36 39 36 36 36 36 36 36 36 36 36 36 36 36 36
36 36 36 36 36 36 36 36 36 36 36 36 36 36 36
36 36 36 36 36 36 36 36 36 36 36 36 36 36 36
36 36 36 36 36 36 36 36 36 36 36 36 36 36 36
36 36 36 36 36 36 36 36 36 36 36 36 36 36 36
36 36 36 36 36 36 36 36 36 36 36 36 36 36 36

4  4  4  4  4  4  4  4  4  4  4  4  4  4  4
0  0  0  0  0  0  0  0  28  0  28  0  0  0  0
0  0  2  0  0  0  0  0  0  0  28  0  0  0  0
0  0  0  0  0  0  0  0  28  0  28  0  0  0  0
0  0  0  0  0  0  0  0  28  0  28  0  0  0  0
28 28 28 28  0  0  0  0  28  25  28  0  0  0  0
0  0  0  28  28  28  28  28  0  0  28  0  0  0  0
0  0  0  25  0  0  0  0  0  0  0  28  0  0  0
0  0  0  28  28  28  28  28  28  28  28  0  0  0  0
4  4  4  4  4  4  4  4  4  4  4  4  4  4  4
#0#0