15 10
1 3
5
3
36 36 36 36 36 36 36 36 36 36 36 36 36 36 36
36 36 36 36 36 36 36 36 36 36 36 36 36 36 36
36 36 36 36 36 36 37 36 36 37 36 36 37 36 36
36 36 36 36 36 36 36 36 36 36 36 36 36 36 36
36 36 36 36 36 36 37 36 36 37 36 36 37 36 36
36 36 36 36 36 36 36 36 36 36 36 36 36 36 36
36 36 36 36 36 36 36 36 36 36 36 36 36 36 36
36 36 36 36 36 36 37 36 36 37 36 36 37 36 36
36 36 36 36 36 36 36 36 36 36 36 36 36 36 36
36 36 36 36 36 36 36 36 36 36 36 36 36 36 36

4  4  4  4  4  4 4  4   4  4  4  4 4  4   4
4  0  0  0  0  0 28  0   0  28  0 0 28  0   4
4  0  0  0  0  0 0  0    0  0  28 0 0   0   4
4  0  0  0  0  0 28  28   28  28  0 0 28  0   4
4  0  0  25  0  0 0  0   0  0  0  0 0  23    4
4  0  0  25  0  0 28  0   0  28  0 0 28  0   4
4  0  0  25  0  0 28  0  0  28  0 0 28  0   4
4  0  0  0  0  0 0  0    0  0  28 28 0  0   4
4  0  0  0  0  0 28  0  0  28  0 0 28  0   4
4  4  4  4  4  4 4  4    4  4  4 4 4  4   4
#0#0