15 10
8 3
5
3
36 36 36 36 36 36 36 36 36 36 36 36 36 36 36
36 36 36 36 36 36 36 36 36 36 36 36 36 36 36
36 36 36 36 36 36 36 36 36 36 36 36 36 36 36
36 36 36 36 36 36 36 36 36 36 36 36 36 36 36
36 36 36 36 36 36 36 36 36 36 36 36 36 36 36
36 36 36 37 36 37 36 36 36 36 36 36 36 36 36
36 36 36 36 36 37 36 36 36 36 36 36 36 36 36
36 36 37 37 36 36 37 37 37 36 37 37 36 36 36
36 36 36 36 36 36 36 36 36 36 36 36 36 36 36
36 36 36 36 36 36 36 36 36 36 36 36 36 36 36

4 4 4 4 4 4 4 4 4 4 4 4 4 4 4
4 4 0 0 0 0 4 4 0 0 0 0 4 4 4
4 4 0 0 0 0 4 4 0 0 25 0 4 4 4
4 4 4 4 0 0 4 4 0 25 4 4 4 4 4
4 4 4 4 0 0 4 4 0 0 4 4 4 4 4
4 4 0 0 0 0 0 0 0 25 0 0 0 4 4
4 4 0 0 25 0 0 0 0 0 0 0 0 4 4
4 4 0 0 4 4 0 0 0 4 0 0 4 4 4
4 4 0 2 4 4 0 25 0 0 25 0 4 4 4
4 4 4 4 4 4 0 0 4 4 0 0 4 4 4
#0#0