15 10
3 2
5
3
36 36 36 36 36 36 36 36 36 36 36 36 36 36 36
36 36 36 36 36 36 36 36 39 36 36 36 36 36 36
36 36 36 36 36 37 36 36 36 36 36 36 39 36 36
36 36 36 36 36 36 36 36 36 36 36 36 36 36 36
36 36 36 36 36 39 36 36 36 36 36 36 36 36 36
36 36 36 36 36 36 36 36 36 36 36 36 36 36 36
36 36 36 36 39 36 36 36 36 36 36 36 36 36 36
36 36 36 39 36 36 36 36 36 37 37 36 39 36 36
36 36 36 36 36 36 36 39 36 36 36 36 36 36 36
36 36 36 36 36 36 36 36 36 36 36 36 36 36 36

4  4  4  4  4  4  4  4  4  4  4  4  4  4  4
4  0  0  5  0  0  0  0  0  0  0  0  0  0  4
4  0  5  0  25  0  0  0  0  0  25  0  25  0  4
4  0  0  5  0  0  0  0  0  0  0  0  0  0  4
4 0  0  0  0  0  0  0  0  0  0  0  0  0  4
4 0  0  0  0  0  0  0  0  0  0  0  0  0  4
4  0  0  0  0  5  0  0  0  0  6  7  6  7  4
4  0  0  5  0  0  0  0  0  0  0  0  0  2  4
4  0  0  0  0  0  5  0  0  0  6  7  6  7  4
4  4  4  4  4  4  4  4  4  4  4  4  4  4  4
#0#0