15 10
7 7
5
3
36 36 36 36 36 36 36 36 36 36 36 36 36 36 36
36 36 37 36 36 36 36 36 37 36 36 36 36 36 36
36 36 36 37 36 37 36 37 36 36 36 36 36 36 36
36 36 36 36 36 36 36 36 39 36 36 37 39 36 36
36 36 36 36 36 36 36 36 36 36 37 37 37 36 36
36 36 36 36 36 36 36 36 36 37 37 37 37 37 36
36 36 36 39 36 36 39 36 37 37 37 36 37 37 37
36 36 36 36 36 36 36 36 36 37 37 37 37 37 36
36 36 36 39 36 36 39 36 36 36 37 37 37 36 36
36 36 36 36 36 36 36 36 36 36 36 37 36 36 36

0  0  28  0  0  0  0  0  28  0  0  0  0  4  4
0  0  0  0  25  25  25  0  0  0  0  0  0  0  4
0  0  0  0  28  0  28  0  0  0  0  0  0  0  0
0  0  0  0  0  25  0  0  0  0  0  0  0  0  0
4  0  0  0  0  0  0  0  0  0  0  0  0  0  0
4  4  0  0  0  25  0  0  0  0  0  0  0  0  0
4  4  4  0  0  0  0  0  0  0  0  2  0  0  0
4  4  4  0  0  0  0  28  0  0  0  0  0  0  0
4  4  4  0  0  0  0  0  0  0  0  0  0  0  0
4  4  4  4  0  0  0  0  0  0  0  0  0  0  0
#0#0